S.##.....T
#H##..###.
#.###E###E
#.....###.
###T#####G
